1111111111111111111111111111111111
1000000000C0C000000000000000000001
1010010100100000101001000000010101
1010010010101010001001000000010101
10000000000P0000000100000001000011
1010010010101001000100100000010101
1000000000E00000001000000001000011
1010010010101010001001000000010101
1E00000000000000000010000000100001
1111111111111111111111111111111111